111111111111111111111111111111111
121000100000101000000000100000001
101010101110101010111110101011101
100010001000100010001000101010001
111111111011111111101110111010111
100000001010000000100010000010001
101111111010111110101011111111111
100010000010000010101000001000001
101010111111111010111111101011101
101010100000000010000000101010101
101010101111111111111110101010101
101000101000000010000010101010101
101111101011111110111010101010101
100000101010000010001000101000101
111110101010111011101111101110101
100000101000100303100010000000101
101111101011101000111011111111101
101000001010001303001010000000001
101110111110111110111010111111101
100000100000100010100010100000101
111111101111101110101110101110101
101000001000100000101000101010101
101011101010101111101011101010111
100010001010000010001000001010001
101110111111111010111011111011101
101000100000001010100000000010001
111010101111101010111111111010111
100010100010001010001000100010001
101110111010111111101010111111101
100010100010001000101010000010001
101011101111101010101011111010101
101000000000100010000010000000101
111111111111111111111111111111111
